*************************************************
*****             *********          *****      *
**                         ********    *****    *
**           ******                     ****    *
*                                               *
*                                               *
*                                               *
*                                               *
*                                               *
*                                               *
*                         ****                  *
*                         ****                  *
*                         ****                  *
*                                               *
*                                               *
*                                               *
*************************************************