********************
****               ************
**                                **
**                                **
**                                **
**                                **
**                                **
********                        *
************************