*********************************************
**                   * *****                                ********
****                      ***                                        **
***                                                       **********
**                                                              ***
**                                                              ***
**                                                              ***
**                                                              ***
**                                                              ***
**                                                              ***
*************************************