13
5 5
*************
* *        @*
* * ***** ***
*   *     * *
* *** ***** *
* * *S*     *
* * *** *****
* *         *
* *** ***** *
*   *     * *
*** ******* *
*           *
*************
