11
9 9
***********
*         *
* *** *** *
* *   *@  *
* * *******
* * *     *
* * * *** *
* *   * * *
* ***** * *
*       *S*
***********
