9
7 3
*********
*       *
***** * *
*     * *
* ***** *
* *@    *
* *** ***
*  S*   *
*********
