17
15 11
*****************
*               *
* ******* *** ***
* *       *     *
* * *********** *
* *         *   *
* ********* * ***
*       * * *   *
******* * * *****
*     *   *     *
* *** *** ***** *
*   * * *    @* *
* * * * * ***** *
* * *   * *     *
* * ***** * *** *
* *       *S*   *
*****************
