15
3 9
***************
*             *
* * ***********
* *     *S    *
* ***** ***** *
*     *     * *
* *** * ***** *
* *   * *     *
* * * *** *****
* * * *   *   *
* * *** *** * *
* *   *   *@* *
* *** *** *** *
*   *         *
***************
