*************************************************
*****             *********          *****      *
**                    ********    *****         *
**           ******                     ****    *
*                                               *
*                                               *
*                                               *
*                                               *
*                                               *
*                                               *
*                         ****                  *
*                         ****                  *
*                         ****                  *
*                                               *
*                                               *
*                                               @
*************************************************