************************
****               *****
**                    **
**                    **
**                    **
**                    **
**                    **
********               @
************************