*****************
* **            *
*               *
*               *
*               *
*               *
*               *
*               *
*           *** *
*           *** *
***         *** *
***             *
*               *
*         **    *
***      *****  *
*        *****  @
*****************